24
24
111111111111111111111111
100000000000000000000001
100000000000000000000001
100022220000000033330001
100020020000000030030001
100020020000000030030001
100022220000000033330001
100000000000000000000001
100000000000000000000001
100000000044440000000001
100000000040040000000001
100000000040040000000001
100000000040040000000001
100000000044440000000001
100000000000000000000001
100000000000000000000001
100055550000000011110001
100050050000000010010001
100050050000000010010001
100055550000000011110001
100000000000000000000001
100000000000000000000001
100000000000000000000001
111111111111111111111111
