16
15
1111111111111111
1000000000000001
1000000300000001
1000000400000001
1000000300000001
1000000400000001
1000000300000001
1000000400000001
1005505555055001
1005000000005001
1005002222005001
1005000000005001
1005555005555001
1000000000000001
1111111111111111
