16
15
1111111111111111
1000000000000001
1000000000000001
1000222200000001
1000200200000001
1000220200000001
1000000000000001
1000000000000001
1000000000000001
1000000003333331
1004040403000031
1000000000005031
1004040403000031
1000000003333331
1111111111111111
